any language=any language
?=-Other-
ar=Arabic
az=Azerbaijani
bn=Bengali
my=Burmese
zh=Chinese
nl=Dutch
en=English
eo=Esperanto
fa=Farsi, Dari
fr=French
de=German
gu=Gujarati
ha=Hausa
he=Hebrew
hi=Hindi
hu=Hungarian
it=Italian
ja=Japanese
jv=Javanese
kn=Kannada
kk=Kazakh
ky=Kirghiz
ko=Korean
ml=Malayalam
mr=Marathi
or=Oriya
pa=Panjabi
ps=Pashto, Pushto
pl=Polish
pt=Portuguese
ro=Romanian
ru=Russian
sr=Serbian
sd=Sindhi
si=Sinhalese
es=Spanish
ta=Tamil
tg=Tajik
te=Telugu
th=Thai
tr=Turkish
tk=Turkmen
uk=Ukranian
ur=Urdu
uz=Uzbek
vi=Vietnamese
